111111111111111111111
111111111E11111111111
111111111C00111111111
11111111CP10111111111
1111111111C0111111111
111111111111111111111
111111111111111111111

