1111111111111111111
1001C0000000C000001
10000111110011111C1
1P0001E000001C00001
1000010000001110111
1111111111111111111
