11111111111111111111111
11C01000000000C00000001
10000C00000001000000001
100001000C000000000C001
10000001000001000000001
10000C00000000000000011
1P0000000000000000000E1
11111111111111111111111
